%%%%%%%%%%%%%%%%%%%%%%%%%%%%%%%%
%%%%%%%%%%%%%%%%%%%%%%%%%%%%%%%%
%%%%%%%%%%%%%%%%%%%%%%%%%%  %%%%
%%%%%%    %%%%%%%%%%%%%%%%  %%%%
%%%%%%              %%%%%%% %%%%
%%%%%%   %%%%%%%%%%%%%%%%%% %%%%
%%%%%%%%%%%%%%%%%%%%%%%%%%%%%%%%
%%%%%%%%%%%%%%%%%%%%%%%%%%%%%%%%
%%%%%%%%%%%%%  %%%%%%%%%%%%%%%%%
%%%%            %%%%%%%%%%%%%%%%
%%%%%%%%%%%%%%%%%%%%%%%%%%%%%%%%
%%%%%%%%%%%%%%%%%%%%%%%%%%%%%%%%
%%%%%%%%%%%%%%%%%%%%%%%%%%%%%%%%
%%%%%%%%%%%%%%%%%%%%%%%%%%%%%%%%
%%%%    %%%%%%%%%%%%%%%%%%%%%%%%
%%%%   %%%%%%%%%%%%%%%%%%%%%%%%%
%%%%  %%%%%%%%%%%%%%%%%%%%%%%%%%
%%%% %%%%%%%%%       %%%%%% %%%%
%%%%%%%%%%%%%%       %%%%%% %%%%
%%%%%%%%%%%%%%%%%%%%%%%%%%% %%%%
%%%%%%%%%%%%%%%%%%%%%%%%%%% %%%%
%%%%%%%%%%%%%%%%%%%%%%%%%%%%%%%%
%%%%             %%%%%%%%%%%%%%%
%%%%             %%%%%%%%%%%%%%%
%%%%             %%%%%%%...%%%%%
%%%%             %%%%%%%...%%%%%
%%%%             %%%%%%%...%%%%%
%%%%             %%%%%%%%%%%%%%%
%%%%             %%%%%%%%%%%%%%%
%%%%%%%%%%%%%%%%%%%%%%%%%%%%%%%%
%%%%%%%%%%%%%%%%%%%%%%%%%%%%%%%%
#
%%%%%%%%%%%%%%%%%%%%%%%%%%%%%%%%
%%%%%%%%%%%%%%%%%%%%%%%%%%%%%%%%
%%%%%%%%%%%%%%%%%%%%%%%%%     %%
%%%%      %%%%%%%%%%%%%%%     %%
%%%%P      %%%%%%%%  %%%%%    %%
%%%%      %%%%%%%%%   %%%%    %%
%%%%%%%%%%%%%%%%%%%%  %%%%    %%
%%%%%%%%%%%%%%%%%%%%%  %%%%   %%
%%%%%%%%%%%%     %%%%  %%%%   %%
%%               %%%%% %%%%%  %%
%%  %%%%%%%%%%%%%%%%%%  %%%%  %%
%%  %%%%%%%%%%%%%%%%%%  %%%%  %%
%%  %%%%%%%%%%%%%%%%%%   %%%  %%
%%  %%%%%%%%%%%%%%%%%%  %%%%  %%
%%       %%%%%%%%%%%%% %%%%%  %%
%%      %%%%%%%%%%%%%%%%%%%   %%
%%     %%%%%%%%%%%%%%%%%%%%   %%
%%    %%%%%%          %%%%    %%
%%   %%%%%%%          %%%%    %%
%%  %%%%%%%%%%%%%%%%%%%%%%    %%
%%  %%%%%%%%%%%%%%%%%%%%%%    %%
%%  %%%%%%%%%%%%%%%%%%%%%%%%%%%%
%%                 %%%%%%%%%%%%%
%%                 %%%%%%%%%%%%%
%%                 %%%  ...  %%%
%%                 %%%  ...  %%%
%%                 %%%  ...  %%%
%%                 %%%%%%%%%%%%%
%%                 %%%%%%%%%%%%%
%%%%%%%%%%%%%%%%%%%%%%%%%%%%%%%%
%%%%%%%%%%%%%%%%%%%%%%%%%%%%%%%%
#
%%%%%%%%%%%%%%%%%%%%%%%%%%%%%%%%
%%%%%%%%%%%%%%%%%%%%%%%%%%%%%%%%
%%%%%%%%%%%%%%%%%%%%%%%%%%%%%%%%
%%%%%%%%%%%%%%%%%%%%%%%%%%%%%%%%
%%%%%%%%%%%%%%%%%%%%%%%%%%    %%
%%%%%%%%%%%%%%%%%%%%%%%%%%    %%
%%%%%%%%%%%%%%%%%%%%  %%%%%   %%
%%%%%%%%%%%%%%%%%%%%% %%%%%   %%
%%%%%%%%%%%%%%%%%%%%%  %%%%   %%
%%%%%%%%%%%%%%%%%%%%%% %%%%%  %%
%%%%%%%%%%%%%%%%%%%%%%  %%%%  %%
%%   %%%%%%%%%%%%%%%%%  %%%%  %%
%%   %%%%%%%%%%%%%%%%%  %%%   %%
%%  %%%%%%%%%%%%%%%%%% %%%%%  %%
%%  %%%%%%%%%%%%%%%%%% %%%%%  %%
%%   %%%%%%%%%%%%%%%%% %%%%%  %%
%%    %%%%%%%%%%%%%%%% %%%%   %%
%%   %%%%%%%%%%%%%%%%% %%%    %%
%%  %%%%%%%%%%%%%%%%%% %%%    %%
%%   %%%%%%%%%%%%%%%%% %%%%%%%%%
%%   %%%%%%%%%%%%%%%%% %%%%%%%%%
%%   %%%%%%%%%%%%%%%%% %%%%%%%%%
%%  %%%%%%%%%%%%%%%%%% %%%%%%%%%
%%   %%%%%%%%%%%%%%%%% %%%%%%%%%
%%                 %%% %%%%%%%%%
%%                 %%%%%%%%%%%%%
%%                 %%%%%%%%%%%%%
%%%%%%%%%%%%%%%%%%%%%%%%%%%%%%%%
%%%%%%%%%%%%%%%%%%%%%%%%%%%%%%%%
%%%%%%%%%%%%%%%%%%%%%%%%%%%%%%%%
%%%%%%%%%%%%%%%%%%%%%%%%%%%%%%%%
#
