%%%%%%%%%%%%%%%%%%%%%%%%%%%%%%%%%%%%%%%%%%%%%%
%%%%%%%%%%%%%%%%%%%%%%%%%%%%%%%%%%%%%%%%%%%%%%
%%%%%%%%%%%%%%%%%%                        %%%%
%%%%%%%   %%%%%%%%%%%%%%%%%%%%%%          %%%%
%%%%%%%    %%%%%%%%%%%%%%%%%%%%%          %%%%
%%%%%%%     %%%%%%%%%%%%%%%%%%%%%         %%%%
%%%%%%%                  %%%%%%%%         %%%%
%%%%%%%     %%%%%%%%%%%%% %%%%%%%%        %%%%
%%%%%%%    %%%%%%%%%%%%%%%%%%%%%%%        %%%%
%%%%%%%%%%%%%%%%%%%%%%%%%% %%%%%%%%       %%%%
%%%%%%%%%%%%%%%%%%%%%%%%%%%%%%%%%%%       %%%%
%%%%%%%%%%%%%%%%%%%%%%%%%%% %%%%%%%%      %%%%
%%%%       %%%%%%%%%%%%%%%% %%%%%%%%      %%%%
%%%%   %%%%%%%%%%%%%%%%%     %%%%%%%%%%%%%%%%%
%%%%%%%%%%%%%%%%%%%%%%%%%%%%%%%%%%%%%%%%%%%%%%
%%%%%%%%%%%%%%%%%%%%%%%%%%%%%%%%%%%%%%%%%%%%%%
%%%%%%%%%%%%%%%%%%%%%%%%%%%%%%%%%%%%%%%%%%%%%%
%%%%                  %%%%%%%%%%%%%%%%%%%%%%%%
%%%%     %%%%%%%%%%%%%%%%%%%%%%%%%%       %%%%
%%%%    %%%%%%%%%%%%%%%%%%%%%%%%%%%       %%%%
%%%%   %%%%%%%%%%%%%%%%%%%%%%%%%%%        %%%%
%%%%  %%%%%%%%%            %%%%%%%        %%%%
%%%% %%%%%%%%%             %%%%%%%        %%%%
%%%%%%%%%%%%%              %%%%%%%        %%%%
%%%%%%%%%%%%%%%%%%%%%%%%%%%%%%%%%%        %%%%
%%%%%%%%%%%%%%%%%%%%%%%%%%%%%%%%%%        %%%%
%%%%%%%%%%%%%%%%%%%%%%%%%%%%%%%%%%        %%%%
%%%%                  %%%%%%%%%%%%%%%%%%%%%%%%
%%%%                  %%%%%%%%%%%%%%%%%%%%%%%%
%%%%                  %%%%%%%     %%%%%%%%%%%%
%%%%                  %%%%%%%.....%%%%%%%%%%%%
%%%%                  %%%%%%%.....%%%%%%%%%%%%
%%%%                  %%%%%%%%%%%%%%%%%%%%%%%%
%%%%%%%%%%%%%%%%%%%%%%%%%%%%%%%%%%%%%%%%%%%%%%
#
%%%%%%%%%%%%%%%%%%%%%%%%%%%%%%%%%%%%%%%%%%%%%%
%%%%%%%%%%%%%%%%%%%%%%%%%%%%%%%%%%%%%%%%%%%%%%
%%%%%%%%%%%%%%%%%%%%%%%%%%%%%%%%%%%%%%%%%%%%%%
%%%%%%%%%%%%%%%%%%%%%%%%%%%%%%             %%%
%%%%%        %%%%%%%%%%%%%%%%%%            %%%
%%%%%P        %%%%%%%%%%%%%%%%%            %%%
%%%%%          %%%%%%%%%%%%%%%%%           %%%
%%%%%        %%%%%%%%%%%   %%%%%           %%%
%%%%%%%%%%%%%%%%%%%%%%%%    %%%%%          %%%
%%%%%%%%%%%%%%%%%%%%%%%%%   %%%%%          %%%
%%%%%%%%%%%%%%%%%%%%%%%%%    %%%%%         %%%
%%%%%%%%%%%%%%%%%%%%%%%%%    %%%%%         %%%
%%%%%%%%%%%%%%%%%%%%%%%%%     %%%%%%%%%%%%%%%%
%%%   %%%%%%%%%%%%%%%%%%%%%   %%%%%%%%%%%%%%%%
%%%  %%%%%%%%%%%%%%%%%%%%%%%   %%%%%%%%%%%%%%%
%%% %%%%%%%%%%%%%%%%%%%%%%%%  %%%%%%%%%%%%%%%%
%%%  %%%%%%%%%%%%%%%%%%%%%%% %%%%%%%%%%%%%%%%%
%%%   %%%%%%%%%%%%%%%%%%%%%% %%%%%%%%%%%%%%%%%
%%%        %%%%%%%%%%%%%%%%% %%%%%%%%%%%%%%%%%
%%%       %%%%%%%%%%%%%%%%%%%%%%%          %%%
%%%      %%%%%%%%%%%%%%%%%% %%%%%          %%%
%%%     %%%%%%%%%%%%%%%%%%  %%%%%          %%%
%%%    %%%%%%               %%%%%          %%%
%%%   %%%%%%%%%%%%%%%%%%%%% %%%%%          %%%
%%%  %%%%%%%%%%%%%%%%%%%%%%%%%%%%          %%%
%%% %%%%%%%%%%%%%%%%%%%%%%%%%%%%%          %%%
%%%  %%%%%%%%%%%%%%%%%%%%%%%%%%%%%%%%%%%   %%%
%%%   %%%%%%%%%%%%%%%%%%%%%%%%%%%%%%%%%%   %%%
%%%                    %%%%%%%%%%%%%%%%%   %%%
%%%                    %%%%% %%%%%%%%%%%   %%%
%%%                    %%%%%  ....  %%%%   %%%
%%%                    %%%%%%%%%%%%%%%%%   %%%
%%%%%%%%%%%%%%%%%%%%%%%%%%%%%%%%%%%%%%%%%%%%%%
%%%%%%%%%%%%%%%%%%%%%%%%%%%%%%%%%%%%%%%%%%%%%%
#
%%%%%%%%%%%%%%%%%%%%%%%%%%%%%%%%%%%%%%%%%%%%%%
%%%%%%%%%%%%%%%%%%%%%%%%%%%%%%%%%%%%%%%%%%%%%%
%%%%%%%%%%%%%%%%%%%%%%%%%%%%%%%%%%%%%%%%%%%%%%
%%%%%%%%%%%%%%%%%%%%%%%%%%%%%%%%%%%%%%%%%%%%%%
%%%%%%%%%%%%%%%%%%%%%%%%%%%%%%%             %%
%%%%%%%%%%%%%%%%%%%%%%%%%%%%%%%             %%
%%%%         %%%%%%%%%%%%%%%%%%%            %%
%%%%%%%%%%%%%%%%%%%%%%%%%%%%%%%%            %%
%%%%%%%%%%%%%%%%%%%%%%%%   %%%%%%           %%
%%%%%%%%%%%%%%%%%%%%%%%%    %%%%%           %%
%%%%%%%%%%%%%%%%%%%%%%%%    %%%%%%%%%%%%%%%%%%
%%%%%%%%%%%%%%%%%%%%%%%      %%%%%%%%%%%%%%%%%
%%%%%%%%%%%%%%%%%%%%%%%%%%%  %%%%%%%%%%%%%%%%%
%%%%%%%%%%%%%%%%%%%%%%%%%%%   %%%%%%%%%%%%%%%%
%%     %%%%%%%%%%%%%%%%%%%%   %%%%%%%%%%%%%%%%
%%     %%%%%%%%%%%%%%%%%%%%   %%%%%%%%%%%%%%%%
%%     %%%%%%%%%%%%%%%%%%%%   %%%%%%%%%%%%%%%%
%%   %%%%%%%%%%%%%%%%%%%%%%  %%%%%%%%%%%%%%%%%
%%   %%%%%%%%%%%%%%%%%%%%%%  %%%%%%%%%%%%%%%%%
%%      %%%%%%%%%%%%%%%%%%%  %%%%%%%%%%%%%%%%%
%%     %%%%%%%%%%%%%%%%%%%%  %%%%%%%%%%%%%%%%%
%%    %%%%%%%%%%%%%%%%%%%%%  %%%            %%
%%   %%%%%%%%%%%%%%%%%%%%%%  %%%            %%
%%   %%%%%%%%%%%%%%%%%%%%%%  %%%            %%
%%     %%%%%%%%%%%%%%%%%%%%  %%%%%%%%%%     %%
%%     %%%%%%%%%%%%%%%%%%%%  %%%%%%%%%%     %%
%%    %%%%%%%%%%%%%%%%%%%%%  %%%%%%%%%%     %%
%%   %%%%%%%%%%%%%%%%%%%%%%  %%%%%%%%%%     %%
%%   %%%%%%%%%%%%%%%%%%%%%%  %%%%%%%%%%     %%
%%                      %%%%%%%%%%%%%%%     %%
%%%%%%%%%%%%%%%%%%%%%%%%%%%%%%%%%%%%%%%%%%%%%%
%%%%%%%%%%%%%%%%%%%%%%%%%%%%%%%%%%%%%%%%%%%%%%
%%%%%%%%%%%%%%%%%%%%%%%%%%%%%%%%%%%%%%%%%%%%%%
%%%%%%%%%%%%%%%%%%%%%%%%%%%%%%%%%%%%%%%%%%%%%%
#
